#header tilemap=0,start=2 2
#background
55,55,55,55,55,55,55,55,55,55,55,55,55,55,55
55,56,02,02,02,02,02,02,02,02,02,02,02,54,55
55,02,75,76,76,76,76,76,76,76,76,76,77,02,55
55,02,93,94,94,94,94,94,94,94,94,94,95,02,55
55,02,93,94,94,94,94,94,94,94,94,94,95,02,55
55,02,93,94,94,94,94,94,94,94,94,94,95,02,55
55,02,93,94,94,94,94,94,94,94,94,94,95,02,55
55,02,93,94,94,94,94,94,94,94,94,94,95,02,55
55,02,93,94,94,94,94,94,94,94,94,94,95,02,55
55,02,93,94,94,94,94,94,94,94,94,94,95,02,55
55,02,93,94,94,94,94,94,94,94,94,94,95,02,55
55,02,93,94,94,94,94,94,94,94,94,94,95,02,55
55,02,93,94,94,94,94,94,94,94,94,94,95,02,55
55,02,111,112,112,112,112,112,112,112,112,112,113,02,55
55,38,02,02,02,02,02,02,02,02,02,02,02,36,55
55,55,55,55,55,55,55,55,55,55,55,55,55,55,55